5 6 6 6 6 6 6 6 6 6 6 6 6 6 6 7
4 0 1 0 0 1 0 0 1 0 1 0 0 1 0 9
4 0 0 1 0 0 1 0 1 0 0 1 0 0 1 9
4 0 1 0 0 1 0 1 0 0 1 0 0 1 0 9
4 0 0 1 1 0 1 0 1 0 0 1 1 0 0 9
4 0 0 1 1 0 1 0 1 0 0 1 1 0 0 9
4 0 0 1 1 0 1 0 1 0 0 1 1 0 0 9
4 0 0 1 1 0 1 0 1 0 0 1 1 0 0 9
4 0 0 1 1 0 1 0 1 0 0 1 1 0 0 9
4 0 0 1 1 0 1 0 1 0 0 1 1 0 0 9
4 0 0 1 1 0 1 0 1 0 0 1 1 0 0 9
4 0 0 1 1 0 1 0 1 0 0 1 1 0 0 9
4 0 0 1 1 0 1 0 1 0 0 1 1 0 0 9
4 0 0 1 1 0 1 0 1 0 0 1 1 0 0 9
4 0 0 1 1 0 1 0 1 0 0 1 1 0 0 9
13 10 10 10 10 10 10 10 10 10 10 10 10 10 10 12