11 5 5 5 5 5 5 5 5 5 5 5 5 5 5 9
4 0 0 24 24 24 3 3 2 0 25 1 1 0 1 7
4 0 0 1 2 3 3 3 2 0 1 1 1 0 1 7
4 0 0 1 2 3 3 3 2 0 1 1 1 0 1 7
4 0 0 1 2 3 3 3 2 0 1 1 1 0 1 7
4 0 0 19 13 13 13 13 13 13 13 13 13 20 1 7
4 0 0 14 28 28 28 28 28 28 28 28 28 15 1 7
4 0 0 14 28 28 28 28 28 28 28 28 28 15 1 7
4 0 0 14 28 28 28 28 28 28 28 28 28 15 1 7
4 0 0 18 16 16 16 21 28 28 28 28 28 15 1 7
4 0 0 1 2 3 3 14 28 28 28 28 28 15 1 7
4 0 0 1 2 3 3 14 28 28 28 28 28 15 1 7
4 0 0 1 2 3 3 18 16 16 16 16 16 17 1 7
4 0 0 1 2 3 3 3 2 0 1 1 1 0 1 7
4 0 0 1 2 3 3 3 2 0 1 1 1 0 1 7
8 6 6 6 6 6 6 6 6 6 6 6 6 6 6 10